
Most similar word for trump -> donald 


Most similar word for prozent -> bruttoinlandsproduktes 


Most similar word for sagte -> kremlsprecher 


Most similar word for spd -> deutschlandkoalition 


Most similar word for afd -> nsdap 


Most similar word for merkel -> angela 


Most similar word for deutschland -> redaktionsnetzwerk 


Most similar word for mehr -> drittplattformen 


Most similar word for sei -> hinnehmbar 


Most similar word for cdu -> führungskrise 


Most similar word for partei -> satirepartei 


Most similar word for usa -> militärmanöver 


Most similar word for menschen -> unantastbar 


Most similar word for wurde -> rechtsstellung 


Most similar word for uhr -> 1630 


Most similar word for schon -> erschwerend 


Most similar word for grünen -> 90die 


Most similar word for seit -> längerem 


Most similar word for immer -> werdende 


Most similar word for union -> deutschlandtag 


Most similar word for regierung -> handlungsfähige 


Most similar word for euro -> brutto 


Most similar word for donald -> uspräsident 


Most similar word for schulz -> spdkanzlerkandidat 


Most similar word for deutschen -> presseagentur 


Most similar word for seehofer -> horst 


Most similar word for gibt -> rätsel 


Most similar word for eu -> gordon 


Most similar word for zwei -> klicks 


Most similar word for worden -> abgerufen 


Most similar word for türkei -> eubeitrittsverhandlungen 


Most similar word for bereits -> pushmitteilung 


Most similar word for jahr -> vergangenes 


Most similar word for geht -> worum 


Most similar word for berlin -> pendelt 


Most similar word for ab -> hau 


Most similar word for polizei -> gdp 


Most similar word for viele -> bürgen 


Most similar word for csu -> lindholz 


Most similar word for neue -> asylflut 


Most similar word for müssen -> aufpassen 


Most similar word for wegen -> verfahrenseinstellungen 


Most similar word for angela -> bundeskanzlerin 


Most similar word for seien -> haltlos 


Most similar word for land -> südamerikanischen 


Most similar word for koalition -> willigen 


Most similar word for jahren -> 70er 


Most similar word for fdp -> jamaikabündnis 


Most similar word for europa -> nordamerika 


Most similar word for ende -> vorzeitiges 


Most similar word for präsident -> jae 


Most similar word for wurden -> asylantrages 


Most similar word for welt -> lpg 


Most similar word for sollen -> gefälligst 


Most similar word for beim -> digitalgipfel 


Most similar word for neuen -> passauer 


Most similar word for dafür -> indiz 


Most similar word for dabei -> herauskommt 


Most similar word for laut -> medienberichts 


Most similar word for kanzlerin -> bierlein 


Most similar word for wer -> mitmacht 


Most similar word for bundesregierung -> ostbeauftragte 


Most similar word for trumps -> wahlkampflager 


Most similar word for wahl -> fdppolitikers 


Most similar word for deutsche -> umwelthilfe 


Most similar word for russland -> trumpteams 


Most similar word for wäre -> wünschenswert 


Most similar word for foto -> spdlogo 


Most similar word for parteien -> wahlprogramme 


Most similar word for frage -> aufgeworfen 


Most similar word for politik -> wirtschaftsentscheider 


Most similar word for sagt -> sicherheitsexperte 


Most similar word for etwa -> itunes 


Most similar word for nachrichtenagentur -> dts 


Most similar word for uspräsident -> donald 


Most similar word for heute -> journal 


Most similar word for kommt -> affiliatelinks 


Most similar word for zeit -> geraumer 


Most similar word for gut -> gelaunt 


Most similar word for 2019 -> österreichwahl 


Most similar word for drei -> bischoff 


Most similar word for ganz -> politikressort 


Most similar word for flüchtlinge -> aufnahmestelle 


Most similar word for allerdings -> unumstritten 


Most similar word for erst -> folgeanträge 


Most similar word for mal -> asylflut 


Most similar word for macht -> hehl 


Most similar word for ja -> na 


Most similar word for bild -> insameinungstrend 


Most similar word for söder -> markus 


Most similar word for krampkarrenbauer -> annegret 


Most similar word for dts -> spdlogo 


Most similar word for sonntag -> wöchentlich 


Most similar word for bundestag -> vertretenen 


Most similar word for erdogan -> recep 


Most similar word for millionen -> 178 


Most similar word for steht -> sternen 


Most similar word for lassen -> ausblenden 


Most similar word for jahre -> alt 


Most similar word for kommen -> angesehene 

